XXXXXXXXXXXXXXXXXXXX
XS111084221XX06X501X
X654138059703950021X
X701444843807X49707X
X8335103X11797161X1X
X7708X0070678305X80X
XX3009434090X5588X1X
X12540X046290038902X
X531773648406660806X
XX54526083532933773X
X60181878074348X260X
X9956945206175607X0X
X002149206139965X67X
X889175X3443X374488X
X43240158021701124XX
X63769311947X9021X9X
X74153942476248XX60X
X6X7341X26X02878916X
X44778006X6281822XGX
XXXXXXXXXXXXXXXXXXXX
